ArduLite	KEYWORD1
PWM	KEYWORD1
Digital	KEYWORD1
Analog	KEYWORD1
ArduLiteUART	KEYWORD1
ArduLiteInterrupt	KEYWORD1
ArduLiteTimerInterrupt	KEYWORD1
uart	KEYWORD1
DEBUG	KEYWORD1
ArduLiteI2C	KEYWORD1
bcdToDec	KEYWORD1
decToBcd	KEYWORD1
debug	KEYWORD1
debugLine	KEYWORD1
ArduLiteTime	KEYWORD1
ArduLitePulse	KEYWORD1
Pulse	KEYWORD1

wait	KEYWORD2
testSpeed	KEYWORD2
toggle	KEYWORD2
setPrescaler	KEYWORD2

OUT	LITERAL1
IN	LITERAL1
main	LITERAL2